{
  "TileTypes": [
    {
      "BlocksMovement": false,
      "BlocksVision": false,
      "Appearance": " "
    },
    {
      "BlocksMovement": true,
      "BlocksVision": true,
      "Appearance": ":"
    }
  ],
  "Width": 50,
  "Height": 36,
  "Tiles": [
    "AAAAAAAAAAAAAAAAAQEAAAABAQAAAQAAAAAAAAEBAQEBAQEAAAAAAAAAAAAAAAAAAAE=",
    "AAAAAAAAAAAAAAAAAQEAAAABAQAAAQAAAAAAAAEBAQEBAQEAAQEAAAAAAAAAAAAAAAE=",
    "AAAAAAAAAAAAAAAAAQEAAAABAQAAAQAAAAAAAAEBAQEBAQEAAQEAAAAAAAAAAAAAAAE=",
    "AAAAAAAAAAEBAQEBAQEAAAABAQAAAQAAAAAAAAEBAQEBAQEAAQEBAQEAAAABAAAAAAE=",
    "AAAAAAAAAAEBAAAAAQEAAAAAAAAAAQAAAAAAAQEBAQEBAQEAAAAAAAABAQAAAAAAAAE=",
    "AAAAAAAAAAAAAAAAAQEAAAAAAAAAAQAAAAAAAQEBAQEBAQEAAAEBAQEBAQAAAAAAAAE=",
    "AAAAAAAAAAAAAAAAAAAAAAAAAAAAAAAAAAAAAAEBAQEBAQEBAQEBAQEBAQAAAAAAAAE=",
    "AAAAAAAAAAAAAAAAAAAAAAAAAAAAAAAAAAAAAAAAAAAAAAABAQEBAAABAQAAAQEAAAA=",
    "AAAAAAAAAAAAAAAAAAAAAAAAAAAAAAAAAAAAAQAAAQAAAAABAQEBAQEBAQAAAAAAAAA=",
    "AAAAAAAAAAAAAAAAAAAAAAAAAAAAAAAAAAAAAAAAAAAAAAAAAAAAAAAAAQEBAQEAAAA=",
    "AQEBAQEBAQEBAQEAAAAAAAAAAAAAAAAAAAAAAQEBAQEAAAAAAAAAAAAAAQEBAQEAAAA=",
    "AQEBAQEBAQEBAQEAAAAAAAAAAAAAAAAAAAAAAQEBAQEAAAAAAAAAAAAAAQEBAQEAAAA=",
    "AAAAAAEBAQEBAQEAAAAAAAAAAAAAAAAAAQEBAQEBAQEAAAAAAAAAAAAAAAAAAAAAAAA=",
    "AQEBAQEBAQEBAQEAAAAAAAAAAAEBAQEBAQEAAQEBAQEBAQAAAAAAAAEBAAAAAAAAAAA=",
    "AAAAAAAAAAAAAAAAAAAAAAAAAAEBAQEBAQEAAQEBAQEBAQAAAAAAAAEBAAAAAAAAAAA=",
    "AAAAAAAAAAAAAAAAAAAAAAAAAAABAQEBAQEAAAAAAAAAAAAAAAAAAAAAAAAAAAAAAAA=",
    "AAAAAAAAAAAAAAAAAAAAAQEBAQABAQEBAQEAAAAAAAAAAAAAAAAAAAAAAAAAAAABAAA=",
    "AAAAAAABAQEBAQEAAAAAAQEBAQAAAAAAAAAAAAAAAAAAAAAAAAAAAAAAAAAAAAABAAA=",
    "AAAAAAABAQEBAQEAAAAAAQEBAQAAAAEBAAAAAAAAAAAAAAAAAAAAAAAAAAAAAAAAAAA=",
    "AAAAAAABAQEBAQEAAAAAAAAAAAEBAQEBAQEAAAAAAAAAAAAAAAABAQEAAAAAAAAAAAA=",
    "AAAAAAABAQEBAQEAAAAAAAAAAAAAAAAAAAAAAAAAAAAAAAAAAAABAQEAAAAAAAAAAAE=",
    "AAAAAAAAAAAAAAAAAAAAAAEBAAAAAAAAAAAAAAAAAAAAAAAAAAABAQEAAAAAAAABAQE=",
    "AAAAAAAAAAAAAAAAAAAAAAEBAAAAAAAAAAAAAQEBAQEAAAAAAAAAAAAAAAAAAAABAQE=",
    "AAAAAAAAAAAAAAAAAAAAAAEBAAAAAAAAAAAAAAAAAAAAAAEBAQAAAAAAAAAAAAABAQE=",
    "AAAAAAAAAAAAAAAAAAAAAAAAAAAAAQAAAAAAAAAAAAAAAAEBAQEAAAAAAAAAAAAAAAA=",
    "AAAAAAAAAAAAAAAAAAAAAAAAAAAAAQAAAAAAAAAAAAAAAAAAAAEBAAAAAAAAAAAAAAA=",
    "AAAAAAAAAAAAAQEBAQAAAAAAAAAAAQAAAAAAAAAAAAAAAAAAAAEBAAAAAAAAAAAAAAA=",
    "AAAAAAAAAAAAAQEBAQEBAQEBAQAAAAAAAAAAAAAAAAEBAQEBAQEBAAAAAAAAAAAAAAA=",
    "AAAAAAAAAAAAAQEBAQEBAQEBAQAAAAAAAAAAAAAAAAEBAQEBAQEBAAAAAAAAAAAAAAA=",
    "AAAAAAAAAAAAAAAAAQEBAQEBAQEBAQEBAAAAAAAAAAEBAAAAAAAAAAAAAAAAAAAAAAA=",
    "AAAAAAAAAAAAAAAAAQEBAQEBAQAAAAAAAQEBAQABAQEBAAAAAAAAAAAAAAAAAAAAAAA=",
    "AAAAAAAAAAAAAAAAAAAAAAAAAAAAAAAAAQEBAAAAAAAAAAAAAAAAAAAAAAAAAAAAAAA=",
    "AAAAAAAAAAAAAAAAAAAAAAAAAAAAAAAAAQEBAAAAAAAAAAAAAAAAAAAAAAEBAQAAAAA=",
    "AAAAAAAAAAAAAAAAAAAAAAAAAAAAAAAAAQEBAAAAAAAAAAAAAAEBAQAAAAAAAAAAAAE=",
    "AAEAAAAAAAAAAAAAAAAAAAAAAAAAAAAAAAAAAAAAAAAAAAAAAAEBAQAAAAAAAAAAAAA=",
    "AAEBAQEBAAAAAAAAAAAAAAAAAAAAAAEBAQABAQEAAAAAAAAAAAAAAAAAAAAAAAAAAAA="
  ],
  "SpawnPointsMap": {
    "1": [
      {
        "X": 5,
        "Y": 1
      },
      {
        "X": 3,
        "Y": 23
      },
      {
        "X": 1,
        "Y": 32
      }
    ]
  },
  "GoalPointsMap": {
    "1": [
      {
        "X": 42,
        "Y": 2
      },
      {
        "X": 49,
        "Y": 16
      },
      {
        "X": 44,
        "Y": 34
      }
    ]
  }
}